#################
# /             #
# !             #
#  @!           #
#               #
#               #
#               #
#               #
#        !!     #
#################
