#################
#               #
# !             #
#  @!           #
#               #
#               #
#               #
#        /      #
#        !!     #
#################
